41 41 41 41 41 41 41 41 41 41 41 41 41 41 41 41 41 41 41 41 41 41 41 41 41 41 41 41 41 41 41 41 41 41 41 41 41 41 41 41 41 41 41 41 41 41 41 41 41 41
41 45 45 45 45 10 10 11 10 10 11 41 41 41 10 41 41 41 14 25 13 13 13 12 22 21 41 41 41 41 41 10 41 10 41 41 41 41 41 41 41 41 41 41 41 41 41 41 41 41
41 45 45 11 41 41 10 10 10 10 11 41 41 41 41 41 14 15 25 13 13 13 22 20 21 41 41 41 41 41 41 10 41 41 10 41 41 41 41 41 10 41 41 10 41 41 41 41 41 41
41 45 10 41 41 41 41 10 10 41 41 41 10 41 41 41 17 12 13 13 12 22 21 41 10 10 41 10 41 41 41 41 41 41 41 41 41 41 41 41 41 41 41 41 41 41 41 41 41 41
41 41 41 41 10 41 41 41 41 41 41 41 41 41 41 14 25 13 13 13 12 18 41 41 10 41 41 41 41 10 41 41 41 41 41 41 41 41 41 41 41 41 41 41 41 41 41 41 41 41
41 41 41 41 41 41 41 41 41 41 41 41 41 41 41 17 13 12 12 12 13 24 15 16 41 41 41 41 41 41 41 41 41 41 41 41 41 41 41 41 41 41 41 41 41 41 41 41 41 41
41 41 41 41 41 41 41 11 41 41 41 41 41 41 41 19 23 12 12 12 13 12 22 21 41 41 41 41 41 41 41 41 41 41 41 41 41 41 41 41 41 41 41 41 41 41 41 41 41 41
41 41 41 41 41 41 41 41 41 41 41 41 41 41 41 41 17 12 12 12 13 13 18 41 41 41 41 41 41 41 41 41 41 41 10 41 41 10 41 41 41 41 41 41 41 41 41 41 41 41
41 41 41 41 41 41 41 41 41 41 41 41 41 41 14 15 25 12 13 12 13 13 18 41 11 41 41 41 41 41 41 41 41 41 41 41 10 41 41 41 41 41 41 41 41 41 41 41 41 41
41 41 41 41 41 41 41 41 41 41 41 41 41 41 41 41 17 12 13 12 13 12 18 41 41 41 10 41 41 41 41 41 41 41 10 41 10 41 41 41 41 41 41 41 41 41 41 41 41 41
41 41 41 41 41 41 41 41 41 41 41 41 41 41 41 41 17 13 12 12 13 13 18 41 41 41 41 41 41 41 41 41 41 41 41 10 41 10 41 41 41 41 41 41 41 41 41 41 41 41
41 41 41 41 41 41 41 41 41 41 41 41 41 41 41 41 17 13 13 13 12 13 24 15 16 41 41 41 41 41 41 41 10 41 41 41 41 41 41 41 41 41 41 41 41 41 41 41 41 41
41 41 41 41 41 41 41 41 41 41 41 41 41 41 41 41 17 12 12 12 12 22 21 41 10 41 11 41 41 41 41 41 41 41 41 41 41 41 41 41 41 41 41 41 41 41 41 41 41 41
41 41 41 41 41 41 41 41 41 41 41 41 41 41 41 14 25 13 12 13 12 18 41 41 41 41 41 41 41 41 41 41 10 41 41 41 41 41 41 41 41 41 41 41 41 41 41 41 41 41
41 10 10 10 41 41 41 41 41 10 41 41 41 41 14 20 23 13 12 12 13 24 16 41 41 41 41 41 41 41 41 41 41 41 41 41 10 41 41 41 41 41 10 41 41 41 41 41 41 41
41 10 10 10 41 41 41 41 41 41 41 41 41 41 41 41 19 23 12 13 12 13 18 41 41 41 41 41 41 41 41 41 10 10 41 41 41 41 41 41 41 41 41 41 41 41 41 41 41 41
41 10 10 10 41 41 41 41 41 41 41 41 41 41 41 41 41 17 12 13 12 12 24 16 41 41 41 41 41 41 41 41 41 41 41 41 41 41 41 41 41 41 41 41 10 10 41 41 41 41
41 10 41 41 41 41 41 41 41 41 41 41 41 41 41 41 41 19 20 23 12 13 13 24 15 16 41 41 41 41 41 41 41 41 41 41 41 41 41 10 41 41 10 41 10 10 10 10 10 41
41 10 41 41 41 41 41 41 11 10 41 10 41 41 41 41 41 41 10 17 13 12 12 13 22 21 41 41 41 41 41 41 41 41 41 41 41 41 41 41 41 41 41 11 10 10 10 11 10 41
41 41 10 41 41 41 41 10 10 41 41 41 41 41 41 41 41 41 14 25 12 13 13 13 18 41 41 41 41 41 41 41 41 41 41 41 41 41 41 41 41 41 41 41 10 10 10 10 11 41
41 10 41 41 10 10 41 41 41 41 41 41 41 10 41 41 41 41 19 20 23 12 12 13 24 15 16 41 41 41 41 41 41 41 41 41 41 41 41 41 41 41 41 41 10 10 10 10 10 41
41 41 41 10 41 41 41 41 41 10 41 41 41 41 41 41 41 41 41 41 17 13 12 12 13 22 21 41 41 41 41 41 41 41 41 41 41 41 41 41 41 10 41 10 10 10 10 10 10 41
41 41 41 41 41 41 41 41 41 41 41 41 41 11 41 41 41 41 41 14 25 13 12 13 12 18 41 41 41 41 41 41 41 41 41 41 41 41 41 10 10 41 41 10 10 11 10 10 11 41
41 41 41 41 41 41 41 41 41 41 41 41 41 41 41 41 41 41 41 19 23 13 12 12 12 24 15 16 41 41 41 41 41 41 41 41 41 41 41 41 41 41 10 10 10 10 10 11 10 41
41 41 41 41 41 41 41 41 41 41 41 41 41 10 41 41 41 41 41 41 19 20 20 20 20 20 21 41 41 41 41 41 41 41 41 41 41 41 41 41 41 41 41 41 10 10 10 10 10 11 41
41 41 10 41 41 41 41 41 41 41 10 41 41 41 41 41 41 41 41 41 41 26 26 26 26 26 26 26 41 41 41 41 41 41 41 41 41 41 41 41 41 41 41 41 10 10 10 10 10 10 41
41 41 41 41 41 41 41 41 41 41 41 41 41 41 41 41 41 41 41 41 41 14 15 15 15 15 15 15 15 16 41 41 41 41 41 41 41 41 41 41 41 41 41 41 41 41 41 10 10 10 41
41 41 41 41 41 41 41 41 41 41 41 41 41 41 41 41 41 41 41 41 41 19 23 13 12 12 12 18 41 41 41 10 41 41 41 41 41 10 41 41 41 41 41 41 41 41 41 11 10 10 41
41 41 41 41 41 41 41 41 41 10 41 41 41 41 41 41 41 41 41 41 41 41 17 13 12 12 12 24 16 41 41 41 41 41 41 41 41 41 11 41 41 41 41 41 41 41 41 41 10 11 41
41 41 41 41 41 41 41 41 41 41 41 41 41 41 41 41 41 41 41 41 41 14 25 13 12 12 13 12 24 16 41 41 41 10 41 41 41 41 41 41 41 10 41 41 41 41 41 41 41 41 41
41 41 41 41 41 41 41 41 41 41 41 41 41 41 41 41 41 10 41 41 41 41 19 23 12 13 12 13 18 41 41 41 11 41 41 41 41 41 41 41 41 41 41 41 41 41 41 41 41 10 41
41 41 41 41 41 41 41 41 41 41 41 41 41 41 41 41 41 41 41 41 41 41 41 17 12 12 13 13 24 16 41 41 41 41 41 10 41 41 41 41 41 41 41 41 41 41 41 41 41 41 41
41 41 41 41 41 41 41 41 41 11 41 41 41 41 41 41 41 41 41 41 41 41 14 25 13 13 12 13 13 24 16 10 41 41 41 41 41 41 41 41 41 41 41 41 41 41 41 41 41 41 41
41 41 41 41 41 41 41 41 41 41 41 41 41 41 41 41 41 41 41 41 41 41 41 19 23 13 13 13 13 18 41 41 41 41 41 41 41 41 41 41 41 41 41 41 41 41 41 41 10 10 41
41 41 45 45 45 45 45 41 41 41 41 41 41 41 41 41 41 41 41 41 41 41 10 41 17 12 13 12 12 24 16 41 41 41 41 41 41 41 41 41 41 41 41 41 41 41 41 41 41 10 41
41 41 45 45 45 45 45 41 41 41 41 41 41 41 41 41 41 41 41 41 41 41 41 14 25 13 12 13 12 22 20 16 41 41 41 41 41 41 41 41 41 41 41 41 41 41 41 41 41 10 41
41 41 45 45 45 45 45 41 41 41 41 41 41 41 41 41 41 41 41 41 41 41 41 17 12 12 12 13 22 21 41 41 41 41 41 41 41 41 41 41 41 41 41 41 41 41 41 41 41 10 41
41 41 45 45 45 45 45 41 41 41 41 41 41 41 41 41 41 41 41 41 41 41 41 41 41 41 41 41 41 41 41 41 41 41 41 41 41 41 41 41 41 41 41 41 41 41 41 41 41 41
41 41 45 45 45 45 45 41 41 41 41 41 41 41 41 41 41 41 10 41 10 14 25 13 12 12 13 22 20 16 41 41 41 41 41 41 41 41 41 41 10 41 41 41 41 41 41 41 10 41 41
41 41 41 41 41 41 41 41 41 41 41 41 41 10 41 41 41 10 41 41 10 17 12 13 12 12 22 21 41 41 41 41 41 41 41 41 41 41 41 41 41 41 41 41 41 41 41 41 41 10 41
41 41 41 41 41 41 41 41 41 41 41 41 41 41 41 41 41 41 41 10 14 25 13 13 12 12 18 41 41 41 41 41 41 41 41 41 41 41 41 41 41 41 41 41 41 41 41 41 41 41 41
41 41 41 41 41 41 41 41 41 41 41 41 41 41 41 41 41 11 10 14 25 13 13 12 13 13 24 16 41 41 41 41 10 41 10 41 10 11 41 41 41 41 41 41 41 41 41 41 41 41 41
41 41 41 41 41 41 41 41 41 41 41 41 41 41 41 41 41 41 41 41 19 23 12 13 12 13 18 41 41 10 41 41 41 41 41 10 10 10 41 41 10 41 41 41 41 41 41 41 41 41 41
41 41 41 41 41 41 41 41 41 41 41 41 41 41 41 41 41 41 41 41 41 17 13 13 13 12 24 16 41 41 10 41 41 10 10 41 11 10 41 41 11 41 41 41 41 41 41 41 41 10 41
41 41 41 41 41 41 41 41 41 41 41 41 41 41 41 41 41 41 41 14 15 25 12 12 12 22 20 21 41 41 41 41 41 10 41 10 10 10 41 41 41 41 41 41 41 41 41 41 41 41 41
41 41 41 41 41 41 41 41 41 41 41 41 41 41 41 41 41 41 41 17 13 13 12 13 22 21 41 41 41 41 41 41 41 10 41 41 10 10 10 41 41 10 41 41 41 41 41 41 41 41 41
41 41 41 41 41 41 41 41 41 41 41 41 41 41 41 41 41 41 14 25 13 12 12 12 18 41 41 41 41 41 41 41 41 41 41 10 11 41 41 41 10 41 41 41 41 41 41 41 10 10 41
41 41 41 41 41 41 41 41 41 41 41 41 41 41 41 41 14 15 25 12 12 13 13 22 21 41 41 41 41 41 41 41 41 10 41 41 10 41 41 41 41 41 10 41 41 41 41 41 41 10 41
41 41 41 41 41 41 41 41 41 41 41 41 41 41 41 41 41 19 23 12 12 12 12 18 41 41 41 41 10 41 10 41 41 41 41 10 10 41 41 41 10 41 41 41 10 41 41 41 41 41 41
41 41 41 41 41 41 41 41 41 41 41 41 41 41 41 41 41 41 41 41 41 41 41 41 41 41 41 41 41 41 41 41 41 41 41 41 41 41 41 41 41 41 41 41 41 41 41 41 41 41
